1111111111111111
1000001001000011
1010101000000001
1010100000110101
1000001000000001
1010101001011011
1010101001010011
1000101101000001
1000000101011101
1000010101011001
1011110000000011
1000010011111011
1000000000000011
1001110111011011
1000000000000001
1111111111111111
