1111111111111111
1000000000000001
1111011110100001
1000000100110101
1011110000000101
1000000101110101
1110110000010001
1000000111000101
1000000001010101
1100111100000101
1000000000010001
1001011000110101
1001010011010101
1001000010000101
1000010000111111
1111111111111111
