1111111111111111
1010000000000111
1000110111100001
1010000000100101
1010100010000101
1000110010110101
1110100010010101
1010001000000001
1000001011100101
1011101000000101
1000000000000001
1000010111000101
1000000000011101
1011110100000101
1000000100111111
1111111111111111
